4,15,15,15,0,0,0,0,0,0
4,4,15,8,0,0,0,0,0,0
4,5,15,8,8,0,0,0,0,0
4,5,13,13,8,8,0,0,0,0
5,5,13,3,0,0,0,0,0,0
5,13,13,3,3,3,3,0,0,0
