16,13,4,4,4,4,0,0,0,0
16,13,13,13,4,0,0,0,0,0
16,14,14,13,5,0,0,0,0,0
16,15,14,14,5,0,0,0,0,0
16,15,14,5,5,0,0,0,0,0
15,15,15,5,0,0,0,0,0,0