15,15,15,7,7,0,0,0,0,0
5,15,4,7,0,0,0,0,0,0
5,15,4,7,7,0,0,0,0,0
5,5,4,4,14,0,0,0,0,0
3,5,4,14,14,0,0,0,0,0
3,3,3,3,14,14,0,0,0,0