10,10,7,7,9,0,0,0,0,0,0,0
10,10,7,9,9,9,0,0,0,0,0,0
10,14,7,7,9,15,0,0,0,0,0,0
14,14,14,5,5,15,0,0,0,0,0,0
14,5,5,5,15,15,15,0,0,0,0,0