7,7,4,4,4,4,0,0,0,0,0,0
7,5,5,5,4,6,0,0,0,0,0,0
7,7,13,5,5,6,0,0,0,0,0,0
13,13,13,6,6,6,0,0,0,0,0,0
13,16,16,16,16,16,0,0,0,0,0