3,3,3,3,9,0,0,0,0,0
3,8,8,9,9,9,0,0,0,0
7,7,8,8,9,0,0,0,0,0
7,5,5,8,0,0,0,0,0,0
7,7,5,5,5,0,0,0,0,0
16,16,16,16,16,0,0,0,0,0