16,16,16,16,16,0,0,0,0,0
15,15,15,5,5,5,0,0,0,0
3,15,5,5,0,0,0,0,0,0
3,15,9,7,7,0,0,0,0,0
3,15,15,15,7,0,0,0,0,0
3,3,9,7,7,0,0,0,0,0