16,10,10,8,0,0,0,0,0,0
16,10,10,8,8,0,0,0,0,0
16,10,7,7,8,8,0,0,0,0
16,13,13,7,6,0,0,0,0,0
16,13,7,7,6,0,0,0,0,0
13,13,6,6,6,0,0,0,0,0