3,3,4,4,4,4,0,0,0,0
3,5,5,5,4,0,0,0,0,0
3,15,8,5,5,0,0,0,0,0
3,15,8,8,0,0,0,0,0,0
15,15,15,8,8,0,0,0,0,0
16,16,16,16,16,0,0,0,0,0