3,3,3,3,0,0,0,0,0,0
6,6,6,3,9,0,0,0,0,0
6,15,8,9,9,9,0,0,0,0
6,15,8,8,9,0,0,0,0,0
15,15,15,8,8,0,0,0,0,0
16,16,16,16,16,0,0,0,0,0