10,10,10,14,14,0,0,0,0,0
10,10,8,8,14,14,0,0,0,0
6,8,8,9,14,0,0,0,0,0
6,8,9,9,9,0,0,0,0,0
6,6,6,9,0,0,0,0,0,0
16,16,16,16,16,0,0,0,0,0