7,7,9,16,16,16,16,16,0,0
7,9,9,9,0,0,0,0,0,0
7,7,9,0,0,0,0,0,0,0
6,6,6,0,0,0,0,0,0,0
6,10,10,0,0,0,0,0,0,0
6,10,10,10,0,0,0,0,0,0