4,4,4,4,0,0,0,0,0,0
10,10,4,0,0,0,0,0,0,0
10,10,10,0,0,0,0,0,0,0
6,6,6,13,0,0,0,0,0,0
6,13,13,13,0,3,0,0,0,0
6,13,3,3,3,3,0,0,0,0