6,6,6,0,0,0,0,0,0,0
6,7,7,9,0,0,0,0,0,0
6,7,9,9,9,0,0,0,0,0
3,7,7,9,0,0,0,0,0,0
3,3,3,3,0,0,0,0,0,0
16,16,16,16,16,0,0,0,0,0